
                  
wwwwwwwwwwwwwwwwwwww
w    w          r rw
w 3  w          le w      
w    w    wwwwwwwwww     
w 2            t   w
w            t s   w
w 1 5     w   wwwwww
w         w   ww e w
w    wwwwww d ww l w
w    w  d     ww   w   
w    w    wwwwww   w
w    t    s      4 w
wwwwwwwwwwwwwwwwwwww