
                  
wwwwwwwwwwwwwwwwwwww
w    w     d       w
w 3  w             w      
w    w     wwwwwwwww     
w 2       r      e w
w         r        w
w 1       w    wwwww
w         w    w e w
w    wwwwww    w   w
w e  w         w   w   
w                t w
w                  w
wwwwwwwwwwwwwwwwwwww






